0 0
2
H 4 4 4 0 0
0 X 0 0 0 0
0 X X X 0 0
0 0 0 0 2 0
0 X X 3 X 0
0 X A 0 0 0