0 7
5
0 X X 0 0 0 X H
0 X 0 0 0 0 X 0
0 X X X A X X 0
0 0 0 0 1 0 X 0
0 X X 0 X 0 0 0
0 X 0 0 X 0 X 0
0 0 0 0 X 3 X 0
0 0 0 0 0 0 X 0