7 1
2
0 X X 0 0 0 X 0
0 X 0 0 X 0 0 0
0 X X 0 A X X 0
0 0 0 0 0 0 X 0
0 X X 0 X 0 0 0
0 X 0 0 X 0 X 0
0 0 0 X X 0 X 0
0 H X 0 0 0 X 0