7 1
5
0 0 X 0 0 0 X 0
0 A 0 0 0 0 0 0
0 X X 3 X X X 0
0 0 0 0 0 0 X 0
0 X X 0 X 0 0 0
3 X 1 0 X 0 X 0
0 0 0 X X 0 X 0
0 H X 0 0 0 X 0